11111111111
11111000061
10100011111
12101110041
10030010111
10101000051
11111111111