11111111111
17111000001
10103011111
12101110001
10000010141
10101000051
11111111111