11111111111
17111000001
10100011111
12101110001
10030010141
10101000051
11111111111